111111111111111111111111111
1E00000000000E0C00000C00001
101001010010000010100100001
101001001010101000100100001
1P0000000C00C000E0000100001
111111111111111111111111111
