111111111111110010000000C110000111110011P0011E0000011111111111111